0,0,2,0,0,0,0,0,0,0,0,0,2,0,0
0,0,2,0,0,0,0,0,0,0,0,0,2,0,0
0,0,2,0,0,0,12,12,12,3,0,0,2,0,0
0,0,2,0,0,0,0,0,0,0,0,0,2,0,0
0,0,2,0,11,11,11,0,0,0,0,0,2,0,0
0,0,2,0,0,0,0,0,0,4,0,0,2,0,0
0,0,2,0,0,0,11,11,11,11,11,0,2,0,0
0,0,2,0,0,0,0,0,0,0,0,0,2,0,0
0,0,2,0,0,0,0,0,0,0,0,0,2,0,0
0,0,1,1,1,1,1,1,1,1,1,1,1,0,0
